111111000000000
000001000000000
000001000000000
000001000000000
000001001111000
000001001001000
000001001001000
000111111001000
000000000001000
000000000001000
000000000001000
000000000001000
000000000001000
000000000001000
000000000001111

