100000000000000
100000000000000
100000000000000
100000000000000
100001111111100
100001000000100
100001000000100
100001111000100
100000001000100
100000001000100
100000001000100
111111111000100
000000000000111
000000000000001
000000000000001

